0000000000000000000000000000000000010101010101010101010101010101010000000000000000000000000000000000
0000000000000000000000000000000000010100000000000000010101010101010000000000000000000000000000000000
0000000000000000000000000000000000010100000000000015010101010101010000000000000000000000000000000000
0000000000000000000000000000000000000000000000000000010101010101010000000000000000000000000000000000
0000000000000000000000000000000000000000000000000000000000010101010000000000000000000000000000000000
0000000000000000000000000000000000000000000000000000000000010101010000000000000000000000000000000000
0000000000000000000000000000000000000000000000000000000000010101010000000000000000000000000000000000
0000000000000000000000000000000000000000000000000000000008010101010000000000000000000000000000000000
0000000000000000000000000000000000000000000000000000000000010101010000000000000000000000000000000000
0000000000000000000000000000000000000000170000020000000000010101010000000000000000000000000000000000
0000000000000000000000000000000000000000000000000000000000091113010000000000000000000000000000000000
0000000000000000000000000000000000000000000000000000000000101214010000000000000000000000000000000000
0000000000000000000000000000000000000000030000160000000006010101010000000000000000000000000000000000
0000000000000000000000000000000000000000000000000000000000010101010000000000000000000000000000000000
0000000000000000000000000000000000000000000000000000000000010101010000000000000000000000000000000000
0000000000000000000000000000000000000000000000000000000000010101010000000000000000000000000000000000
0000000000000000000000000000000000000000000000001818181804010101010000000000000000000000000000000000
0000000000000000000000000000000000000000000000000101010101010101010000000000000000000000000000000000
0000000000000000000000000000000000000000000000070101010101010101010000000000000000000000000000000000
0000000000000000000000000000000000000000000000000101010101010101010000000000000000000000000000000000
0000000000000000000000000000000000000000000000000000000000091113010000000000000000000000000000000000
0000000000000000000000000000000000000000000000000000000000101214010000000000000000000000000000000000
0000000000000000000000000000000000000000000000000100000000010101010000000000000000000000000000000000
0000000000000000000000000000000000000000000000000100000000010101010000000000000000000000000000000000
0000000000000000000000000000000000000000000000000100000000010101010000000000000000000000000000000000
0000000000000000000000000000000000000000000000000100000000010101010000000000000000000000000000000000
0000000000000000000000000000000000000000000000000000000000010101010000000000000000000000000000000000
0000000000000000000000000000000000000000000000000000000008010101010000000000000000000000000000000000
0000000000000000000000000000000000000000000000000000000000010101010000000000000000000000000000000000
0000000000000000000000000000000000000000000000000000000000010101010000000000000000000000000000000000
0000000000000000000000000000000000000000000000000000000000010101010000000000000000000000000000000000
0000000000000000000000000000000000000000000000000000000000010101010000000000000000000000000000000000
0000000000000000000000000000000000000000000000000000000000020101010000000000000000000000000000000000
0000000000000000000000000000000000000000000000000000000000010101010000000000000000000000000000000000
0000000000000000000000000000000000000000000000000000000000010101010000000000000000000000000000000000
0000000000000000000000000000000000000000000000000000000000010101010000000000000000000000000000000000
0000000000000000000000000000000000000000000000000000000000010101010000000000000000000000000000000000
0000000000000000000000000000000000000000000000000000000100091113010000000000000000000000000000000000
0000000000000000000000000000000000000000000000000000000100101214010000000000000000000000000000000000
0000000000000000000000000000000000000000000000000000000100091113010000000000000000000000000000000000
0000000000000000000000000000000000000000000000000000000100101214010000000000000000000000000000000000
0000000000000000000000000000000000000000000000000000010000091113010000000000000000000000000000000000
0000000000000000000000000000000000000000000000000000010000101214010000000000000000000000000000000000
0000000000000000000000000000000000000000000000000000010000091113010000000000000000000000000000000000
0000000000000000000000000000000000000000000000000000010000101214010000000000000000000000000000000000
0000000000000000000000000000000000000000000000000000000000091113010000000000000000000000000000000000
0000000000000000000000000000000000000000000000000000000000101214010000000000000000000000000000000000
0000000000000000000000000000000000000000000000000000010101010101010000000000000000000000000000000000
0000000000000000000000000000000000000000000000000000010101010101010000000000000000000000000000000000
0000000000000000000000000000000000000000000000000000010101010101010000000000000000000000000000000000
0000000000000000000000000000000000000000000000000000010101010101010000000000000000000000000000000000
0000000000000000000000000000000000000000000000000000010101010101010000000000000000000000000000000000
0000000000000000000000000000000000000000000000000000010101010101010000000000000000000000000000000000
0000000000000000000000000000000000000000000000000000030101010101010000000000000000000000000000000000
0000000000000000000000000000000000000000000000000000010101010101010000000000000000000000000000000000
0000000000000000000000000000000000000000000000000000010101010101010000000000000000000000000000000000
0000000000000000000000000000000000000000000000000008010101010101010000000000000000000000000000000000
0000000000000000000000000000000000000000000000000000010101010101010000000000000000000000000000000000
0000000000000000000000000000000000000000000000000000010101010101010000000000000000000000000000000000
0000000000000000000000000000000000000000000000000000010101010101010000000000000000000000000000000000
0000000000000000000000000000000000000000000000000000020101010101010000000000000000000000000000000000
0000000000000000000000000000000000000000000000000000010101010101010000000000000000000000000000000000
0000000000000000000000000000000000000000000000000000010101010101010000000000000000000000000000000000
0000000000000000000000000000000000000000000000000000010101010101010000000000000000000000000000000000
0000000000000000000000000000000000000000000000000000010101010101010000000000000000000000000000000000
0000000000000000000000000000000000000000000000000000010101010101010000000000000000000000000000000000
0000000000000000000000000000000000000000000000000000010101010101010000000000000000000000000000000000
0000000000000000000000000000000000000000000000000000091113010101010000000000000000000000000000000000
0000000000000000000000000000000000000000000000000000101214010101010000000000000000000000000000000000
0000000000000000000000000000000000000000000000000000010101010101010000000000000000000000000000000000
0000000000000000000000000000000000000000000000000000010101010101010000000000000000000000000000000000
0000000000000000000000000000000000000000000000000000010101010101010000000000000000000000000000000000
0000000000000000000000000000000000000000000000000000010101010101010000000000000000000000000000000000
0000000000000000000000000000000000000000000000000000160101010101010000000000000000000000000000000000
0000000000000000000000000000000000000000000000000000010101010101010000000000000000000000000000000000
0000000000000000000000000000000000000000000000000007010101010101010000000000000000000000000000000000
0000000000000000000000000000000000000000000000000000010101010101010000000000000000000000000000000000
0000000000000000000000000000000000000000000000000000010101010101010000000000000000000000000000000000
0000000000000000000000000000000000000000000000000000010101010101010000000000000000000000000000000000
0000000000000000000000000000000000000000000000000000010101010101010000000000000000000000000000000000
0000000000000000000000000000000000000000001818181804010101010101010000000000000000000000000000000000
0000000000000000000000000000000000000000000101010101010101010000000000000000000000000000000000000000
0000000000000000000000000000000000000000000101010101010101010000000000000000000000000000000000000000
0000000000000000000000000000000000000000000101010101010101010000000000000000000000000000000000000000
0000000000000000000000000000000000000000000101010101010101010000000000000000000000000000000000000000
0000000000000000000000000000000000000000170101010101010101010000000000000000000000000000000000000000
0000000000000000000000000000000000000017010101010101010101010000000000000000000000000000000000000000
0000000000000000000000000000000000001601010101010101010101010000000000000000000000000000000000000000
0000000000000000000000000000000000170101010101010101010101010000000000000000000000000000000000000000
0000000000000000000000000000000000091113010101010101010101010000000000000000000000000000000000000000
0000000000000000000000000000000000101214010101010101010101010000000000000000000000000000000000000000
0000000000000000000000000000000000010101010101010101010101010000000000000000000000000000000000000000
0000000000000000000000000000000000010101010101010101010101010000000000000000000000000000000000000000
0000000000000000000000000000000000010101010101010100000000000000000000000000000000000000000000000000
0000000000000000000000000000000000010101010101010100000000000000000000000000000000000000000000000000
0000000000000000000000000000000000010101010101010100000000000000000000000000000000000000000000000000
0000000000000000000000000000000000010101010101010100000000000000000000000000000000000000000000000000
0000000000000000000000000000000500010101010101010100000000000000000000000000000000000000000000000000
0000000000000000000000000000000500010101010101010100000000000000000000000000000000000000000000000000
0000000000000000000000000000000500010101010101010100000000000000000000000000000000000000000000000000
