1111111111
1000000001
1000000001
1000000001
1002000001
1000000001
1000000001
1000002001
1000000001
1000000001
1000000001
1002000001
1000000001
1000000001
1000002001
1000000001
1000000001
1000000001
1002000001
1000000001
1000000001
1000002001
1000000001
1000000001
1002000001
1000000001
1000000001
1000002001
1000000001
1000000001
1002000001
1000000001
1000000001
1000002001
1000000001
1000000001
1002000001
1000000001
1000000001
1111111111
