0000000000000000000000000000010101010101010101010101000000000000000000000000000000000000000000000000
0000000000000000000000000000010101010101010101010101010000000000000000000000000000000000000000000000
0000000000000000000000000000010100000000000001010101010100000000000000000000000000000000000000000000
0000000000000000000000000000010100000000001501010101010101000000000000000000000000000000000000000000
0000000000000000000000000000000000000000000001010101010101000000000000000000000000000000000000000000
0000000000000000000000000000000000000000000001010101010101000000000000000000000000000000000000000000
0000000000000000000000000000000000000000000001010101010101010000000000000000000000000000000000000000
0000000000000000000000000000000000000000000001010101010101010000000000000000000000000000000000000000
0000000000000000000000000000000000000000000001010101010101010000000000000000000000000000000000000000
0000000000000000000000000000000000000000000001010101010101010100000000000000000000000000000000000000
0000000000000000000000000000000000000000000001010101010101010100000000000000000000000000000000000000
0000000000000000000000000000000000000000000001010101010101010100000000000000000000000000000000000000
0000000000000000000000000000000000000000170001010101010101010100000000000000000000000000000000000000
0000000000000000000000000000000000000000000001010101010101010101000000000000000000000000000000000000
0000000000000000000000000000000000000000000001010101010101010101000000000000000000000000000000000000
0000000000000000000000000000000000000000000001010101010101010101010000000000000000000000000000000000
0000000000000000000000000000000000000000030001010101010101010101010000000000000000000000000000000000
0000000000000000000000000000000000000000170801010101010101010101010000000000000000000000000000000000
0000000000000000000000000000000000001600030001010101010101010101010100000000000000000000000000000000
0000000000000000000000000000000000000000170001010101010101010101010101000000000000000000000000000000
0000000000000000000000000000000000000000030001010101010101010101010101010000000000000000000000000000
0000000000000000000000000000000000000000000001010101010101010101010101010100000000000000000000000000
0000000000000000000000000000000000000000000001010101010101010101010101010101000000000000000000000000
0000000000000000000000000000000000000000000001010101010000010101010101010101010100000000000000000000
0000000000000000000000000000000000000000000001010101010000010101010101010101010101010000000000000000
0000000000000000000000000000000000000000000101010101010000010101010101010101010101010000000000000000
0000000000000000000000000000000000000000000101010101010000010101010101010101010101010100000000000000
0000000000000000000000000000000000000000000001010101010002010101010101010101010101010100000000000000
0000000000000000000000000000000000000000000001010101010000010101010101010101010101010101000000000000
0000000000000000000000000000000000000000000001010101010000010101010101010101010101010101000000000000
0000000000000000000000000000000000000000000001010101010000000000000000000001010101010101000000000000
0000000000000000000000000000000000001818180401010101010000000000000000000001010101010101000000000000
0000000000000000000000000000000000000101010101010101010000000000000000000001010101010101000000000000
0000000000000000000000000000000000001818181901010101170000010000000000000001010101010101000000000000
0000000000000000000000000000000000000000000001010101010000010000000000000009111301010101000000000000
0000000000000000000000000000000000000000000001010101010000010000000000000010121401010101000000000000
0000000000000000000000000000000000000000000001010101010000010000000000000001010101010101000000000000
0000000000000000000000000000000000000005010001010101010000170000000000000001010101010101000000000000
0000000000000000000000000000000000000005010001010101170000010000000000000101010101010101000000000000
0000000000000000000000000000000000000000000001010101010000010000000000010101010101010101000000000000
0000000000000000000000000000000000000000000001010101010000010003000000010000010101010101000000000000
0000000000000000000000000000000000000000000001010101010000160000000000000000010101010101000000000000
0000000000000000000000000000000000000000000001010101010000010000000000000003010101010101000000000000
0000000000000000000000000000000000000000000009111301170000010000000000000000010101010101000000000000
0000000000000000000000000000000000000000000010121401010000010000000000000000010101010101000000000000
0000000000000000000000000000000000000000000001010101010000170000000000000000010101010101000000000000
0000000000000000000000000000000000000000000701010101010000010000000000000000010101010101000000000000
0000000000000000000000000000000000000000000001010101010000010000000000000001010101010101000000000000
0000000000000000000000000000000000000000000001010101170000010000000000000101010101010101000000000000
0000000000000000000000000000000000000000000001010101010000010000000000000101010101010101000000000000
0000000000000000000000000000000000000000000001010101010000010000000000010101010101010101000000000000
0000000000000000000000000000000000000000010101010101010000010000000000010101010101010101000000000000
0000000000000000000000000000000000000000010101010101010001010000000000010101010101010101000000000000
0000000000000000000000000000000000000000091113010101010001010000000000010101010101010101000000000000
0000000000000000000000000000000000000000101214010101010001010100000000091113010101010101000000000000
0000000000000000000000000000000000000000091113010101010001010000001700101214010101010101000000000000
0000000000000000000000000000000000000000101214010101010003010000000000091113010101010101000000000000
0000000000000000000000000000000000000000010101010116010000010000000000101214010101010101000000000000
0000000000000000000000000000000000000000010101010101010000010000170000091113010101010101000000000000
0000000000000000000000000000000000000000181818181818180000010000000000101214010101010101000000000000
0000000000000000000000000000000000000000000000000000000000010000000000091113010101010101000000000000
0000000000000000000000000000000000000000000000000000000000010000000300101214010101010101000000000000
0000000000000000000001040404040404040404040000000000000001010000000000010101010101010101000000000000
0000000000000000000001010101010101010101010101010101010101010000000000010101010101010101000000000000
0000000000000000000001010101010101010101010101010101010101010300000000010101010101010101000000000000
0000000000000000000000000000000000000000000000000000000000000000000000010101010101010101000000000000
0000000000000000000018181818181818181818181818181818181818181818181818010101010101010101000000000000
0000000000000000000001010101010201010101010101010101010101010101010101010101010101010100000000000000
0000000000000000000001010101010101010101010101010101010101010101010101010101010101010100000000000000
0000000000000000000001010101010101010101010101010101010101010101010101010101010101010100000000000000
0000000000000000000000000911130101010101010101010101010101010101010101010101010101010100000000000000
0000000000000001010000001012140101010101010101010101010101010101010101010101010101010000000000000000
0000000000000001010000000911130101010101010101010101010101010101010101010101010101000000000000000000
0000000000000001010000001012140101010101010101010101010101010101010101010101000000000000000000000000
0000000000000001010000000912130101010101010101010101010101010101000000000000000000000000000000000000
0000000000000000000000001012140101010101010101010101010101010100000000000000000000000000000000000000
0000000000000000000000000911130101010101010101010101010100000000000000000000000000000000000000000000
0000000000000000000000001012140101010101010101010101010000000000000000000000000000000000000000000000
0000000000000000000000000911130101010101010101010101000000000000000000000000000000000000000000000000
0000000000000000001600001012140101010101010101010000000000000000000000000000000000000000000000000000
0000000000000000000000010101010101010101010100000000000000000000000000000000000000000000000000000000
0000000000000000000000010101010101010101010000000000000000000000000000000000000000000000000000000000
0000000000000000000000010101010101010101000000000000000000000000000000000000000000000000000000000000
0000000000000000000000010101010101010101000000000000000000000000000000000000000000000000000000000000
0000000000000000000000010101010101010100000000000000000000000000000000000000000000000000000000000000
0000000000000000000000010101010101010100000000000000000000000000000000000000000000000000000000000000
0000000000000000000000010101010101010000000000000000000000000000000000000000000000000000000000000000
0000000000000000000001010101010101000000000000000000000000000000000000000000000000000000000000000000
0000000000000000000001010101010101000000000000000000000000000000000000000000000000000000000000000000
0000000000000000000101010101010101000000000000000000000000000000000000000000000000000000000000000000
0000000000000000000101010101010101000000000000000000000000000000000000000000000000000000000000000000
0000000000000000000101010101010100000000000000000000000000000000000000000000000000000000000000000000
0000000000000000000101010101010100000000000000000000000000000000000000000000000000000000000000000000
0000000000000000060101010101010000000000000000000000000000000000000000000000000000000000000000000000
0000000000010101010101010101000000000000000000000000000000000000000000000000000000000000000000000000
0000000000010101010101010100000000000000000000000000000000000000000000000000000000000000000000000000
0000000000000000000000000000000000000000000000000000000000000000000000000000000000000000000000000000
0000000000000000000000000000000000000000000000000000000000000000000000000000000000000000000000000000
0000000000000000000000000000000000000000000000000000000000000000000000000000000000000000000000000000
0000000000000000000000000000000000000000000000000000000000000000000000000000000000000000000000000000
0000000000000000000000000000000000000000000000000000000000000000000000000000000000000000000000000000
0000000000000000000000000000000000000000000000000000000000000000000000000000000000000000000000000000
0000000000000000000000000000000000000000000000000000000000000000000000000000000000000000000000000000
0000000000000000000000000000000000000000000000000000000000000000000000000000000000000000000000000000
0000000000000000000000000000000000000000000000000000000000000000000000000000000000000000000000000000
0000000000000000000000000000000000000000000000000000000000000000000000000000000000000000000000000000
0000000000000000000000000000000000000000000000000000000000000000000000000000000000000000000000000000
0000000000000000000000000000000000000000000000000000000000000000000000000000000000000000000000000000
0000000000000000000000000000000000000000000000000000000000000000000000000000000000000000000000000000
0000000000000000000000000000000000000000000000000000000000000000000000000000000000000000000000000000
0000000000000000000000000000000000000000000000000000000000000000000000000000000000000000000000000000
0000000000000000000000000000000000000000000000000000000000000000000000000000000000000000000000000000
0000000000000000000000000000000000000000000000000000000000000000000000000000000000000000000000000000
0000000000000000000000000000000000000000000000000000000000000000000000000000000000000000000000000000
0000000000000000000000000000000000000000000000000000000000000000000000000000000000000000000000000000
0000000000000000000000000000000000000000000000000000000000000000000000000000000000000000000000000000
0000000000000000000000000000000000000000000000000000000000000000000000000000000000000000000000000000
0000000000000000000000000000000000000000000000000000000000000000000000000000000000000000000000000000
0000000000000000000000000000000000000000000000000000000000000000000000000000000000000000000000000000
0000000000000000000000000000000000000000000000000000000000000000000000000000000000000000000000000000
0000000000000000000000000000000000000000000000000000000000000000000000000000000000000000000000000000
0000000000000000000000000000000000000000000000000000000000000000000000000000000000000000000000000000
0000000000000000000000000000000000000000000000000000000000000000000000000000000000000000000000000000
0000000000000000000000000000000000000000000000000000000000000000000000000000000000000000000000000000
0000000000000000000000000000000000000000000000000000000000000000000000000000000000000000000000000000
0000000000000000000000000000000000000000000000000000000000000000000000000000000000000000000000000000
0000000000000000000000000000000000000000000000000000000000000000000000000000000000000000000000000000
0000000000000000000000000000000000000000000000000000000000000000000000000000000000000000000000000000
0000000000000000000000000000000000000000000000000000000000000000000000000000000000000000000000000000
0000000000000000000000000000000000000000000000000000000000000000000000000000000000000000000000000000
0000000000000000000000000000000000000000000000000000000000000000000000000000000000000000000000000000
0000000000000000000000000000000000000000000000000000000000000000000000000000000000000000000000000000
0000000000000000000000000000000000000000000000000000000000000000000000000000000000000000000000000000
0000000000000000000000000000000000000000000000000000000000000000000000000000000000000000000000000000
0000000000000000000000000000000000000000000000000000000000000000000000000000000000000000000000000000
0000000000000000000000000000000000000000000000000000000000000000000000000000000000000000000000000000
0000000000000000000000000000000000000000000000000000000000000000000000000000000000000000000000000000
0000000000000000000000000000000000000000000000000000000000000000000000000000000000000000000000000000
0000000000000000000000000000000000000000000000000000000000000000000000000000000000000000000000000000
0000000000000000000000000000000000000000000000000000000000000000000000000000000000000000000000000000
0000000000000000000000000000000000000000000000000000000000000000000000000000000000000000000000000000
0000000000000000000000000000000000000000000000000000000000000000000000000000000000000000000000000000
0000000000000000000000000000000000000000000000000000000000000000000000000000000000000000000000000000
0000000000000000000000000000000000000000000000000000000000000000000000000000000000000000000000000000
0000000000000000000000000000000000000000000000000000000000000000000000000000000000000000000000000000
0000000000000000000000000000000000000000000000000000000000000000000000000000000000000000000000000000
0000000000000000000000000000000000000000000000000000000000000000000000000000000000000000000000000000
0000000000000000000000000000000000000000000000000000000000000000000000000000000000000000000000000000
0000000000000000000000000000000000000000000000000000000000000000000000000000000000000000000000000000
0000000000000000000000000000000000000000000000000000000000000000000000000000000000000000000000000000
