0000000000000000000000010101010101010101010101010101010101010000000000000000000000000000000000000000
0000000000000000000000010101010101010101010101010101010101010000000000000000000000000000000000000000
0000000000000000000000010100000000000001010101010101010101010000000000000000000000000000000000000000
0000000000000000000000012100000000001501010101010101010101010000000000000000000000000000000000000000
0000000000000000000000000000000000000023010101010101010101010000000000000000000000000000000000000000
0000000000000000000000000000000000000000000001010101010101010000000000000000000000000000000000000000
0000000000000000000000000000000000000000000001010101010101010000000000000000000000000000000000000000
0000000000000000000000000000000000000000000001010101010101010000000000000000000000000000000000000000
0000000000000000000000000000000000000000000001010101010101010000000000000000000000000000000000000000
0000000000000000000000000000000000000000000001010101010101010000000000000000000000000000000000000000
0000000000000000000000000000000000000000000801010101010101010000000000000000000000000000000000000000
0000000000000000000000000000000000000000000001010101010101010000000000000000000000000000000000000000
0000000000000000000000000000000000000000000001010101010101010000000000000000000000000000000000000000
0000000000000000000000000000000000000022200009111301010101010000000000000000000000000000000000000000
0000000000000000000000000000000000000001010010121401010101010000000000000000000000000000000000000000
0000000000000000000000000000000000000701010009111301010101010000000000000000000000000000000000000000
0000000000000000000000000000000000000023210010121401010101010000000000000000000000000000000000000000
0000000000000000000000000000000000000000000009111301010101010000000000000000000000000000000000000000
0000000000000000000000000000000000000000000010121401010101010000000000000000000000000000000000000000
0000000000000000000000000000000000000000000009111301010101010000000000000000000000000000000000000000
0000000000000000000000000000000000002220000010121401010101010100000000000000000000000000000000000000
0000000000000000000000000000000000000521000009111301010101010100000000000000000000000000000000000000
0000000000000000000000000000000000000000000010121401010101000000000000000000000000000000000000000000
0000000000000000000000000000000000000000000009111301010101010000000000000000000000000000000000000000
0000000000000000000000000000000000002220000010121401010101010000000000000000000000000000000000000000
0000000000000000000000000000000000000501160009111301010101010000000000000000000000000000000000000000
0000000000020000000000000000000000000000000010121401010101010000000000000000000000000000000000000000
0000000000010000000000000000000000000520000009111301010101010000000000000000000000000000000000000000
0000000000010101010101012000000000000101000010121401010101010000000000000000000000000000000000000000
0000000000010101010101010100000000002321000009111301010101010000000000000000000000000000000000000000
0000000000010101010101010100000000000000000010121401010101010000000000000000000000000000000000000000
0000000000181818181818180100000000220101010101010101010101010000000000000000000000000000000000000000
0000000000000000000000000100000000010101010101010101010101000000000000000000000000000000000000000000
0000000000000000000000000100000000091113010101010101010101000000000000000000000000000000000000000000
0000000000220404040400002100000000101214010101010101010101000000000000000000000000000000000000000000
0000000000010101010100000000000000011701010101010101000001000000000000000000000000000000000000000000
0000000000230101010100000000000000011701010101010101000001000000000000000000000000000000000000000000
0000000000000000010100000000222000091113010101010101000001000000000000000000000000000000000000000000
0000000000000000010100000000010100101214010101010101000000000000000000000000000000000000000000000000
0000000000000000010100000000010100091113010101010101000001000000000000000000000000000000000000000000
0000000000000000010100000000010100101214010101010101000001000000000000000000000000000000000000000000
0000000000000000010100000000050100091113010101010101000001000000000000000000000000000000000000000000
0000000000000000010100000000050100101214010101010101000001000000000000000000000000000000000000000000
0000000000000007010100000000050100091113010101010101000001000000000000000000000000000000000000000000
0000000000000000010100000000050100101214010101010101000001000000000000000000000000000000000000000000
0000000000000000010100000000050101010101010101010101010100000000000000000000000000000000000000000000
0000000000000000050100000000050101010101010101010101000000000000000000000000000000000000000000000000
0000000000000000050100000000050101010101010101010101000000000000000000000000000000000000000000000000
0000000000000000010100000000050101010101010101010101000000000000000000000000000000000000000000000000
0000000000000000010100000000050101010101010101010101000000000000000000000000000000000000000000000000
0000000000000000010117000016010101010101010101010101000000000000000000000000000000000000000000000000
0000000000000000010101010101010101010101010101010101000000000000000000000000000000000000000000000000
0000000000000000010119191919191818181818180101010101000000000000000000000000000000000000000000000000
0000000000000000010101010101000000000000000101010101000000000000000000000000000000000000000000000000
0000000000000000230101010101000000000000000101010101000000000000000000000000000000000000000000000000
0000000000000000000000030101000000000000000101010101000000000000000000000000000000000000000000000000
0000000000000000000000000101000000000000000101010101000000000000000000000000000000000000000000000000
0000000000000000000000000101000000000000000101010101000000000000000000000000000000000000000000000000
0000000000000000000000002321000000222000000101010101000000000000000000000000000000000000000000000000
0000000000000000000000000000000000010100000101010101000000000000000000000000000000000000000000000000
0000000000000000000000000000000000010100000101010101000000000000000000000000000000000000000000000000
0000000000000000000000000501000000012100000101010101000000000000000000000000000000000000000000000000
0000000000000000000000000501000008010000000101010101000000000000000000000000000000000000000000000000
0000000000000000000000000521000000010000000101010101000000000000000000000000000000000000000000000000
0000000000000000000000000000000000010000000101010101000000000000000000000000000000000000000000000000
0000000000000000000000000000000000010000000101010101000000000000000000000000000000000000000000000000
0000000000000000040404040404040404010000070101010101000000000000000000000000000000000000000000000000
0000000000000000230101010101010101210000000101010101000000000000000000000000000000000000000000000000
0000000000000000000000000000000000000000000911130101000000000000000000000000000000000000000000000000
0000000000000000000000000000000000000000001012140101000000000000000000000000000000000000000000000000
0000000000000000000000000000000000000000000101010101000000000000000000000000000000000000000000000000
0000000000000000000000000000000000000000000101010101010000000000000000000000000000000000000000000000
0000000000000000000000000000000000000000001701010101010000000000000000000000000000000000000000000000
0000000000000000000000000000000000000000001701010101000000000000000000000000000000000000000000000000
0000000000000000000000000000000000000000001701010101000000000000000000000000000000000000000000000000
0000000000000000000000000000000000000000000301010101000000000000000000000000000000000000000000000000
0000000000000000000000000000000000000000000301010101000000000000000000000000000000000000000000000000
0000000000000000000000000000000000000000000301010101000000000000000000000000000000000000000000000000
0000000000000000000000000000000000000000001601010101000000000000000000000000000000000000000000000000
0000000000000000000000000000000018181818180101010101000000000000000000000000000000000000000000000000
0000000000000000000000000000000001010101010101010101000000000000000000000000000000000000000000000000
0000000000000000000000000000000001010101010101010101000000000000000000000000000000000000000000000000
0000000000000000000000000000000001010101010101010101000000000000000000000000000000000000000000000000
0000000000000000000000000000000009111301010101010101000000000000000000000000000000000000000000000000
0000000000000000000000000000000010121401010101010101000000000000000000000000000000000000000000000000
0000000000000000000000000000000001010101010101010101000000000000000000000000000000000000000000000000
0000000000000000000000000000000023010101010101010101000000000000000000000000000000000000000000000000
0000000000000000000000000000000000000501010101010101000000000000000000000000000000000000000000000000
0000000000000000000000000000000000000501010101010101000000000000000000000000000000000000000000000000
0000000000000000000000000000000000170501010101010101000000000000000000000000000000000000000000000000
0000000000000000000000000000000000000501010101010101000000000000000000000000000000000000000000000000
0000000000000000000000000000000000000005010101010101000000000000000000000000000000000000000000000000
0000000000000000000000000000000000000005010101010101000000000000000000000000000000000000000000000000
0000000000000000000000000000000000001605010101010101000000000000000000000000000000000000000000000000
0000000000000000000000000000000000000005010101010101000000000000000000000000000000000000000000000000
0000000000000000000000000000000000000005010101010101000000000000000000000000000000000000000000000000
0000000000000000160000000000000000000000010101010101000000000000000000000000000000000000000000000000
0000000022010101010101010120000000000000010101010101000000000000000000000000000000000000000000000000
0000000023010101010101010101000000000000010101010101000000000000000000000000000000000000000000000000
0000000000000000000000000101010101200000010101010101000000000000000000000000000000000000000000000000
0000000000000000000000000101010101010000010101010101000000000000000000000000000000000000000000000000
0000000000000000000000001919191919190000010101010101000000000000000000000000000000000000000000000000
0000000000000000000000000000000000000000010101010101000000000000000000000000000000000000000000000000
0000000000000000000000000000000000000000010101010101000000000000000000000000000000000000000000000000
0000000000000000000000001818181818181804010101010101000000000000000000000000000000000000000000000000
0000000000000000000000000101010101010101010101010101000000000000000000000000000000000000000000000000
0000000000000000000000002301010101010101010101010101000000000000000000000000000000000000000000000000
0000000000000000000000000000010101010101010101010101000000000000000000000000000000000000000000000000
0000000000000000000000000000010101010101010101010101000000000000000000000000000000000000000000000000
0000000000000000002220000000010101010101010101010101000000000000000000000000000000000000000000000000
0000000000000000000101000000101113010101010101010101000000000000000000000000000000000000000000000000
0000000000000000000101000000101214010101010101010101000000000000000000000000000000000000000000000000
0000000000000000000101000000101113010101010101010000000000000000000000000000000000000000000000000000
0000000000000000000101000000101214010101010100010000000000000000000000000000000000000000000000000000
0000000000000000000101000000101113010101010100010000000000000000000000000000000000000000000000000000
0000000000000000080101000000101214010101010100000000000000000000000000000000000000000000000000000000
0000000000000000000101000000091113010101010100000000000000000000000000000000000000000000000000000000
0000000000000000000101000000101214010101010100000000000000000000000000000000000000000000000000000000
0000000000000000002321000000091113010101010100000000000000000000000000000000000000000000000000000000
0000000000000000000000000000101214010101010100000000000000000000000000000000000000000000000000000000
0000000000000000000000000000010101010101010100000000000000000000000000000000000000000000000000000000
0000000000000000000000000000010101010101010100000000000000000000000000000000000000000000000000000000
0000000000000000000000000000010101010101010100000000000000000000000000000000000000000000000000000000
0000000000000000000000000000010101010101010100000000000000000000000000000000000000000000000000000000
0000000000000000000000001704010101010101010100000000000000000000000000000000000000000000000000000000
0000000000000000000000000101010101010101010100000000000000000000000000000000000000000000000000000000
0000000000000000000000000101010101010101010100000000000000000000000000000000000000000000000000000000
0000000000000000000000000101010101010101010100000000000000000000000000000000000000000000000000000000
0000000000000000000000000101010101010101010100000000000000000000000000000000000000000000000000000000
0000000000000000000000000101010101010101010100000000000000000000000000000000000000000000000000000000
0000000000220100000000000101010101010101010100000000000000000000000000000000000000000000000000000000
0000000000010100000000000101010101010101010100000000000000000000000000000000000000000000000000000000
0000000000010100000000060101010101010101010100000000000000000000000000000000000000000000000000000000
0000000000010101010101010101010101010101010100000000000000000000000000000000000000000000000000000000
0000000000010101010101010101010101010101010100000000000000000000000000000000000000000000000000000000
0000000000010100000000000000000000000000000000000000000000000000000000000000000000000000000000000000
0000000000000000000000000000000000000000000000000000000000000000000000000000000000000000000000000000
0000000000000000000000000000000000000000000000000000000000000000000000000000000000000000000000000000
0000000000000000000000000000000000000000000000000000000000000000000000000000000000000000000000000000
0000000000000000000000000000000000000000000000000000000000000000000000000000000000000000000000000000
0000000000000000000000000000000000000000000000000000000000000000000000000000000000000000000000000000
0000000000000000000000000000000000000000000000000000000000000000000000000000000000000000000000000000
0000000000000000000000000000000000000000000000000000000000000000000000000000000000000000000000000000
0000000000000000000000000000000000000000000000000000000000000000000000000000000000000000000000000000
0000000000000000000000000000000000000000000000000000000000000000000000000000000000000000000000000000
0000000000000000000000000000000000000000000000000000000000000000000000000000000000000000000000000000
0000000000000000000000000000000000000000000000000000000000000000000000000000000000000000000000000000
0000000000000000000000000000000000000000000000000000000000000000000000000000000000000000000000000000
0000000000000000000000000000000000000000000000000000000000000000000000000000000000000000000000000000
0000000000000000000000000000000000000000000000000000000000000000000000000000000000000000000000000000
