0000000000000000000000000101010101010101010101010101010101010101010101010101010100000000000000000000
0000000000000000000000000101010101010101010101010101010101010101010101010101010100000000000000000000
0000000000000000000000000101010000000000000001010101010101010101010101010101010100000000000000000000
0000000000000000000000000101010000000000001501010101010101010101010101010101010100000000000000000000
0000000000000000000000000101010000000000000001010101010101010116010101010101010100000000000000000000
0000000000000000000000000101010100000000000000000001010000000001010101010101010100000000000000000000
0000000000000000000000000000000000000000000000000001010000000001010101010101010100000000000000000000
0000000000000000000000000000000000000000000000000001010000000001010101010101010100000000000000000000
0000000000000000000000000000000000000000000000000001010000000018181818010101010100000000000000000000
0000000000000000000000000000000000000000000000000001010000000000000000010101010100000000000000000000
0000000000000000000000000000000000000000000000000001010000000000000000010101010100000000000000000000
0000000000000000000000000000000000000000000000000000000000000000000000010101010100000000000000000000
0000000000000000000000000000000000000000000000000000000000000000000008010101010100000000000000000000
0000000000000000000000000000000000000000000000000000000000000000000000010101010100000000000000000000
0000000000000000000000000000000000000000000000000000000000000000000000010101010100000000000000000000
0000000000000000000000000000000000000000000000000000000000000000000000091113010100000000000000000000
0000000000000000000000000000000000000000000000000000000000000000000000101214010100000000000000000000
0000000000000000000000000000000000000000000000000000000000000000000000010101010100000000000000000000
0000000000000000000000000000000000000000000000000000000000000000000000010101010100000000000000000000
0000000000000000000000000000000000000000000000000001010101010000000000010101010100000000000000000000
0000000000000000000000000000000000000000000000000018181818180000000000010101010100000000000000000000
0000000000000000000000000000000000000000000000000000000000000018181818010101010100000000000000000000
0000000000000000000000000000000000000000000000000000000000000001010101010101010100000000000000000000
0000000000000000000000000000000000000000000000000001040404040001010101010101010100000000000000000000
0000000000000000000000000000000000000000000000000001010101010001010101010101010100000000000000000000
0000000000000000000000000000000000000000000000000000000000000009111301010101010100000000000000000000
0000000000000000000000000000000000000000000000000000000000000010121401010101010100000000000000000000
0000000000000000000000000000000000000000000000000017000000000009111301010101010100000000000000000000
0000000000000000000000000000000000000000000000000000000000000010121401010101010100000000000000000000
0000000000000000000000000000000000000000000000000000000000000009111301010101010100000000000000000000
0000000000000000000000000000000000000000000000000000001700000010121401010101010100000000000000000000
0000000000000000000000000000000000000000000000000000000000000009111301010101010100000000000000000000
0000000000000000000000000000000000000000000000000000000000000010121401010101010100000000000000000000
0000000000000000000000000000000000000000000000000000000000160009111301010101010100000000000000000000
0000000000000000000000000000000000000000000000000000000000000010121401010101010100000000000000000000
0000000000000000000000000000000000000000000000000000000000000009111301010101010100000000000000000000
0000000000000000000000000000000000000000000000000000000017000010121401010101010100000000000000000000
0000000000000000000000000000000000000000000000000000000000000009111301010101010100000000000000000000
0000000000000000000000000000000000000000000000000000000000000010121401010101010100000000000000000000
0000000000000000000000000000000000000000000000000000000001010101010101010101010100000000000000000000
0000000000000000000000000000000000000000000000000000000009111301010101010101010100000000000000000000
0000000000000000000000000000000000000000000000000000000010121401010101010101010100000000000000000000
0000000000000000000000000000000000000000000000000000000002010101010101010101010100000000000000000000
0000000000000000000000000000000000000000000000000000000009111301010101010101010100000000000000000000
0000000000000000000000000000000000000000000000000000000010121401010101010101010100000000000000000000
0000000000000000000000000000001600000000000000000000000001010101010101010101010100000000000000000000
0000000000000000000000000000000000000000000000000000000001010101010101010101010100000000000000000000
0000000000000000000000000000000000000000000000000000000801010101010101010101010100000000000000000000
0000000000000000000000000000000100000000000000000000000001010101010101010101010100000000000000000000
0000000000000000000000000000000100000000000000000000000001010101010101010101010100000000000000000000
0000000000000000000000000000000100000000000000000000000001010101010101010101010000000000000000000000
0000000000000000000000000000000001000000000000000018181801010101010101010101000000000000000000000000
0000000000000000000000000000000000010000000000000001010101010101010101010100000000000000000000000000
0000000000000000000000000000000000000101010101010001010101010101010101010100000000000000000000000000
0000000000000000000000000000000000000019191919190701010101010101010101010000000000000000000000000000
0000000000000000000000000000000000000000000000000001010101010101010101010000000000000000000000000000
0000000000000000000000000000000000000000000000000001010101010101010101000000000000000000000000000000
0000000000000000000000000000000000001818181818181801010101010101010100000000000000000000000000000000
0000000000000000000000000000000000000101010101010101010101010101010100000000000000000000000000000000
0000000000000000000000000000000000000101010101010101010101010101010100000000000000000000000000000000
0000000000000000000000000000000000000101010101010101010101010101010100000000000000000000000000000000
0000000000000000000000000000000000000101010101010101010101010101010100000000000000000000000000000000
0000000000000000000000000000000000000101010101010101010101010101010100000000000000000000000000000000
0000000000000000000000000000000000000000000911130101010101010101010100000000000000000000000000000000
0000000000000000000000000000000000000000001012140101010101010101010100000000000000000000000000000000
0000000000000000000000000017000000170000000911130101010101010101010100000000000000000000000000000000
0000000000000000000000000000000000000000001012140101010101010101010100000000000000000000000000000000
0000000000000000000000000000000000000000000911130101010101010101010100000000000000000000000000000000
0000000000000000000000000000000000000101010101010101010101010101010100000000000000000000000000000000
0000000000000000000000000000000000000101010101010101010101010101010101000000000000000000000000000000
0000000000000000000000000000000000000101010101010101010101010101010101000000000000000000000000000000
0000000000000000000000000000000000000101010101010101010101010101010101000000000000000000000000000000
0000000000000000000000000000000000000101010101010101010101010101010101000000000000000000000000000000
0000000000000000000000000000000000000911130101010101010101010101010101010000000000000000000000000000
0000000000000000000000000000000000001012140101010101010101010101010101010000000000000000000000000000
0000000000000000000000000000000000000101010101010101010101010101010101010000000000000000000000000000
0000000000000000000000000000000000000101010101010101010101010101010101010100000000000000000000000000
0000000000000000000000000000000000001601010101010101010101010101010101010100000000000000000000000000
0000000000000000000000000000000000000101010101010101010101010101010101010101000000000000000000000000
0000000000000000000000000000000000000101010101010101010101010101010101010101000000000000000000000000
0000000000000000000000000000000000000911130101010101010101010101010101010101000000000000000000000000
0000000000000000000000000000000000001012140101010101010101010101010101010101000000000000000000000000
0000000000000000000000000000000000000101010101010101010101010101010101010101000000000000000000000000
0000000000000000000000000000000000000101010101010101010101010101010101010101000000000000000000000000
0000000000000000000000000000000000001818190101010101010101010101010101010101000000000000000000000000
0000000000000000000000000000000000000000000101010101010101010101010101010101000000000000000000000000
0000000000000000000000000000000000000000000101010101010101010101010101010101000000000000000000000000
0000000000000000000000000000000000000000001818181818181818181801010101010101000000000000000000000000
0000000000000000000000000000000000000005000000000000000000000001010101010101000000000000000000000000
0000000000000000000000000000000000000005000000000000000000000001010101010101000000000000000000000000
0000000000000000000000000000000000000005000000000000000000000001010101010101000000000000000000000000
0000000000000000000000000000000000000205000000000000000000000001010101010101000000000000000000000000
0000000000000000000000000000000000000000001818181818040404040001010101010101000000000000000000000000
0000000000000000000000000000000000000000000100000000000000010001010101010101000000000000000000000000
0000000000000000000000000000000000000000001818181818181818180001010101010101000000000000000000000000
0000000000000000000000000000000000000000000000000000000000000001010101010101000000000000000000000000
0000000000000000000000000000000000000000000000000000000000000001010101010101000000000000000000000000
0000000000000000000000000000000000000000000104040404040404040001010101010101000000000000000000000000
0000000000000000000000000000000000000000000100000000000000010009111301010101000000000000000000000000
0000000000000000000000000000000000000000000101010101010101010010121401010101000000000000000000000000
0000000000000000000000000000000000000000000000000000000000000001010101010101000000000000000000000000
0000000000000000000000000000000000000000000000000000000000000001010101010101000000000000000000000000
0000000000000000000000000000000000000000030000000000000000000001010101010101000000000000000000000000
0000000000000000000000000000000000000000000104040404040404040401010101010101000000000000000000000000
0000000000000000000000000000000000000000000101010101010101010101010101010101000000000000000000000000
0000000000000000000000000000000000000000000101010101010101010101010101010101000000000000000000000000
0000000000000000000000000000000000000000000101010101010101010101010101010101000000000000000000000000
0000000000000000000000000000000000000000000101010101010101010101010101010101000000000000000000000000
0000000000000000000000000000000000000000000101010101010101010101010101010101000000000000000000000000
0000000000000000000000000000000000000000070101010101010101010101010101010101000000000000000000000000
0000000000000000000000000000000000000000000101010101010101010101010101010101000000000000000000000000
0000000000000000000000000000000000000000000101010101010101010101010101010101000000000000000000000000
0000000000000000000000000000000000000000000101010101010101010101010101010100000000000000000000000000
0000000000000000000000000000000000000000000101010101010101010101010101000000000000000000000000000000
0000000000000000000000000000000000000000000101010101010101010101010100000000000000000000000000000000
0000000000000000000000000000000000181818040101010101010101010101010000000000000000000000000000000000
0000000000000000000000000000000000010101010101010101010101010101010000000000000000000000000000000000
0000000000000000000000000000000000010101010101010101010101010100000000000000000000000000000000000000
0000000000000000000001010000000000010101010101010101010101010000000000000000000000000000000000000000
0000000000000000000001010000000000010101010101010101010101000000000000000000000000000000000000000000
0000000000000000000001010000000006010101010101010101010100000000000000000000000000000000000000000000
0000000000000000000001010101010101010101010101010101010000000000000000000000000000000000000000000000
0000000000000000000001010101010101010101010101010101000000000000000000000000000000000000000000000000
0000000000000000000001010101010101010101010101010100000000000000000000000000000000000000000000000000
0000000000000000000000000000000000000000000000000000000000000000000000000000000000000000000000000000
0000000000000000000000000000000000000000000000000000000000000000000000000000000000000000000000000000
0000000000000000000000000000000000000000000000000000000000000000000000000000000000000000000000000000
0000000000000000000000000000000000000000000000000000000000000000000000000000000000000000000000000000
0000000000000000000000000000000000000000000000000000000000000000000000000000000000000000000000000000
0000000000000000000000000000000000000000000000000000000000000000000000000000000000000000000000000000
0000000000000000000000000000000000000000000000000000000000000000000000000000000000000000000000000000
0000000000000000000000000000000000000000000000000000000000000000000000000000000000000000000000000000
0000000000000000000000000000000000000000000000000000000000000000000000000000000000000000000000000000
0000000000000000000000000000000000000000000000000000000000000000000000000000000000000000000000000000
0000000000000000000000000000000000000000000000000000000000000000000000000000000000000000000000000000
0000000000000000000000000000000000000000000000000000000000000000000000000000000000000000000000000000
0000000000000000000000000000000000000000000000000000000000000000000000000000000000000000000000000000
0000000000000000000000000000000000000000000000000000000000000000000000000000000000000000000000000000
0000000000000000000000000000000000000000000000000000000000000000000000000000000000000000000000000000
0000000000000000000000000000000000000000000000000000000000000000000000000000000000000000000000000000
0000000000000000000000000000000000000000000000000000000000000000000000000000000000000000000000000000
0000000000000000000000000000000000000000000000000000000000000000000000000000000000000000000000000000
0000000000000000000000000000000000000000000000000000000000000000000000000000000000000000000000000000
0000000000000000000000000000000000000000000000000000000000000000000000000000000000000000000000000000
0000000000000000000000000000000000000000000000000000000000000000000000000000000000000000000000000000
0000000000000000000000000000000000000000000000000000000000000000000000000000000000000000000000000000
0000000000000000000000000000000000000000000000000000000000000000000000000000000000000000000000000000
0000000000000000000000000000000000000000000000000000000000000000000000000000000000000000000000000000
0000000000000000000000000000000000000000000000000000000000000000000000000000000000000000000000000000
0000000000000000000000000000000000000000000000000000000000000000000000000000000000000000000000000000
