0000000000000000000000000000000001010101010101010101010101010101010100000000000000000000000000000000
0000000000000000000000000000000001010101010101010101010101010101010100000000000000000000000000000000
0000000000000000000000000000000001010000000000010101010101010101010100000000000000000000000000000000
0000000000000000000000000000000001010000000015010101010101010101010100000000000000000000000000000000
0000000000000000000000000000000000000000000000010101010101010101010100000000000000000000000000000000
0000000000000000000000000000000000000000000000000001010101010101010100000000000000000000000000000000
0000000000000000000000000000000000000000000000000001010101010101010100000000000000000000000000000000
0000000000000000000000000000000000000000000000000001010101010101010100000000000000000000000000000000
0000000000000000000000000000000000000000000000000002010101010101010100000000000000000000000000000000
0000000000000000000000000000000000000000000000000001010101010101010100000000000000000000000000000000
0000000000000000000000000000000000000000000000000001010101010101010100000000000000000000000000000000
0000000000000000000000000000000000000000000000000001010101010101010100000000000000000000000000000000
0000000000000000000000000000000000000000000000000001010101010101010100000000000000000000000000000000
0000000000000000000000000000000000000000000000000003010101010101010100000000000000000000000000000000
0000000000000000000000000000000000000000000000000001010101010101010100000000000000000000000000000000
0000000000000000000000000000000000000000000000000001010101010101010100000000000000000000000000000000
0000000000000000000000000000000000000000000000000001010101010101010100000000000000000000000000000000
0000000000000000000000000000000000000000000000000001010101010101010100000000000000000000000000000000
0000000000000000000000000000000000000000000000000001010101010101010101000000000000000000000000000000
0000000000000000000000000000000000000000000000000016010101010101010101000000000000000000000000000000
0000000000000000000000000000000000000000000000000001010101010101010101010000000000000000000000000000
0000000000000000000000000000000000000000000000000001010101010101010100000000000000000000000000000000
0000000000000000000000000000000000000000000000000001010101010101010100000000000000000000000000000000
0000000000000000000000000000000000000000000000000001010101010101010100000000000000000000000000000000
0000000000000000000000000000000000000000000000000001010101010101010100000000000000000000000000000000
0000000000000000000000000000000000000000000000000001010101010101010100000000000000000000000000000000
0000000000000000000000000000000000000000000000000017010101010101010100000000000000000000000000000000
0000000000000000000000000000000000000000000000000001010101010101010100000000000000000000000000000000
0000000000000000000000000000000000000000000000000001010101010101010100000000000000000000000000000000
0000000000000000000000000000000000000000000000000001010101010101010100000000000000000000000000000000
0000000000000000000000000000000000000000000000000001010101010101010100000000000000000000000000000000
0000000000000000000000000000000000000000000000000001010101010101010100000000000000000000000000000000
0000000000000000000000000000000000000000181818181801010101010101010100000000000000000000000000000000
0000000000000000000000000000000000000000010101010101010101010101010100000000000000000000000000000000
0000000000000000000000000000000000000000010101010101010101010101010100000000000000000000000000000000
0000000000000000000000000000000000000000010101010101010101010101010100000000000000000000000000000000
0000000000000000000000000000000000000000010101010101010101010101010100000000000000000000000000000000
0000000000000000000000000000001818181804010101010101010101010101010100000000000000000000000000000000
0000000000000000000000000000000101010101010101010101010101010101010100000000000000000000000000000000
0000000000000000000000000000000101010101010101010101010101010101010100000000000000000000000000000000
0000000000000000000000000000000101010101010101010101010101010101010100000000000000000000000000000000
0000000000000000000000000000000101010101010101010101010101010101010100000000000000000000000000000000
0000000000000000000000000000000101010101010101010101010101010101010100000000000000000000000000000000
0000000000000000000000000000000101010101010101010101010101010101010100000000000000000000000000000000
0000000000000000000000000000000101010101010101010101010101010101010100000000000000000000000000000000
0000000000000000000000000100000911130101010101010101010101010101010100000000000000000000000000000000
0000000000000000000000000100001012140101010101010101010101010101010100000000000000000000000000000000
0000000000000000000000000100000911130101010101010101010101010101010100000000000000000000000000000000
0000000000000000000000000100001012140101010101010101010101010101010100000000000000000000000000000000
0000000000000000000000000000000101010101010101010101010101010101010100000000000000000000000000000000
0000000000000000000000000000000101010101010101010101010101010101010100000000000000000000000000000000
0000000000000000000000000000000101010101010101010101010101010101010100000000000000000000000000000000
0000000000000000000000000000001601010101010101010101010101010101010100000000000000000000000000000000
0000000000000000000000000000000101010101010101010101010101010101010100000000000000000000000000000000
0000000000000000000000000000000101010101010101010101010101010101010100000000000000000000000000000000
0000000000000000000000000000000101010101010101010101010101010101010100000000000000000000000000000000
0000000000000000000000000500000101010101010101010101010101010101010100000000000000000000000000000000
0000000000000000000000000500000101010101010101010101010101010101010100000000000000000000000000000000
0000000000000000000000000500000101010101010101010101010101010101010100000000000000000000000000000000
0000000000000000000000000500000101010101010101010101010101010101010100000000000000000000000000000000
0000000000000000000000000000000101010101010101010101010101010101010100000000000000000000000000000000
0000000000000000000000000000000101010101010101010101010101010101010100000000000000000000000000000000
0000000000000000000000000000000101010101010101010101010101010101010100000000000000000000000000000000
0000000000000000000000000000001818181819010101010101010101010101010100000000000000000000000000000000
0000000000000000000000000000000000000000010101010101010101010101010100000000000000000000000000000000
0000000000000000000000000000000000000000010101010101010101010101010100000000000000000000000000000000
0000000000000000000000000000000000010000010101010101010101010101010100000000000000000000000000000000
0000000000000000000000000000000000000000000101010101010101010101010100000000000000000000000000000000
0000000000000000000000000000000000000000000001010101010101010101010100000000000000000000000000000000
0000000000000000000000000000000504040400000001010101010101010101010100000000000000000000000000000000
0000000000000000000000000000000501010101000001010101010101010101010100000000000000000000000000000000
0000000000000000000000000000000501010101000005010101010101010101010000000000000000000000000000000000
0000000000000000000000000000000501010101000001010101010101010101010000000000000000000000000000000000
0000000000000000000000000000000501010100000001010101010101010101010000000000000000000000000000000000
0000000000000000000000000000000000000000000001010101010101010101010000000000000000000000000000000000
0000000000000000000000000000000000000000000101010101010101010101010000000000000000000000000000000000
0000000000000000000000000000000000000000010101010101010101010101000000000000000000000000000000000000
0000000000000000000000000000001600000000020101010101010101010101000000000000000000000000000000000000
0000000000000000000000000000000000000000010101010101010101010101000000000000000000000000000000000000
0000000000000000000000000000000000000000000000000701010101010100000000000000000000000000000000000000
0000000000000000000000000101010101000000000000000101010101010100000000000000000000000000000000000000
0000000000000000000000000101010101010101000000000101010101010100000000000000000000000000000000000000
0000000000000000000000000101010101010101010000000101010101010100000000000000000000000000000000000000
0000000000000000000000000001010101010101010100000101010101010100000000000000000000000000000000000000
0000000000000000000000000001010101010101010100000101010101010100000000000000000000000000000000000000
0000000000000000000000000000010101010101010100000101010101010100000000000000000000000000000000000000
0000000000000000000000000000010101010101010100000116010101010100000000000000000000000000000000000000
0000000000000000000000000000000101010101010100000101010101010100000000000000000000000000000000000000
0000000000000000000000000000000101010101010100000101010101010100000000000000000000000000000000000000
0000000000000000000000000000000001010101010100000101010101010100000000000000000000000000000000000000
0000000000000000000000000000000019191919191900000101010101010100000000000000000000000000000000000000
0000000000000000000000000000000000000000000000000101010101010000000000000000000000000000000000000000
0000000000000000000000000000000000000000000000000101010101010000000000000000000000000000000000000000
0000000000000000000000000000000018181818181818180101010101010000000000000000000000000000000000000000
0000000000000000000000000000000001010101010101010101010101010000000000000000000000000000000000000000
0000000000000000000000000000000001010101010101010101010101010000000000000000000000000000000000000000
0000000000000000000000000000000601010101010101010101010101010000000000000000000000000000000000000000
0000000000000000000000000000000001010101010101010101010101010000000000000000000000000000000000000000
0000000000000000000000000000000001010101010101010101010101010000000000000000000000000000000000000000
0000000000000000000000000000000001010101010101010101010101000000000000000000000000000000000000000000
