1111000111
1000111101
1000000001
1000000001
1000000001
1000000014
1000110014
1000141411
1000144121
1000141412
1000104121
1001510414
1044001440
1004401408
1000415140
1000441081
1000041081
1000041081
1000344081
1000001081
0000001080
0000001080
0001101080
0010111080
0010011080
0000001080
0010011000
0001010100
0001111100
0001101000
0000001000
0000001000
0000020000
0002200000
0000000000
0000000000
0000000000
0000000000
0000000000
0000000000
