11110001110000000001
10001111010000000001
10000000010000000001
10000000010000000001
10000000010000000001
10000000010000000001
10000000010000000001
10000000010000000001
10000000010000000001
10000000010000000001
10000000010000000001
10000000010000000001
10000000010000000001
10000000010000000001
10000000010000000001
10000000010000000001
10000000010000000001
10000000010000000001
10000000010000000001
10000000011111111111
