0000000000000000000000000000000000000000000000000000000000000000000000000000000000000000000000000000
0000000000000000000000000000000000000000000000000000000000000000000000000000000000000000000000000000
0000000000000000000000000000000000000000000000000000000000000000000000000000000000000000000000000000
0000000000000000000000000000000000000000000000000000000000000000000000000000000000000000000000000000
0101010101010101010101010101010101010101010101010101010101010101010101010101010101010101010101010101
0100000000000000000000000000000000000000000000000000000000000000000000000000000000000000050101010101
0100000000000000000000000000000000000000000000000000000000000000000000000000000000000000000009111301
0100000000000000000000000000000000000000000000000000000000000000000000000000000000000000000009121401
0100000000000000000000000000000000000000000000000000000000000000000000000000000000000000000009111301
0100000000000000000000000000000000000000000000000000000000000000000000000000000000000000000010121401
0100000000000000000000000000000000000000000000000000000000000000000000000000000000000000000009111301
0100000000000000000000000000000000000000000000000000000000000000000000000000000000000000000010121401
0100000000000000000000000000000000000000000000000000000000000000000000000000000000000000000009111301
0100000000000000000000000101010101010101010101010101010101010100000000000000000000000000000010121401
0100000000000000000000150101010101010101010101010101010101010100000000000000000000000000000009111301
0100000000000000000000000101010101010101010101010101010101010100000000000000000000000000000010121401
0100000000000000000000000101010101010101010101010101010101010100000000000000000000000000000009111301
0100000000000000000000000101010000000001010101000000000000000000000000000000000000000000000010121401
0100000000000000000000000101010000000001010101000000000000000000000000000000000000000000000009111301
0100000000000000000000000101010000000001010101000000000000000000000000000000000000000000000010121401
0100000000000000000000000101010000000001010101000000000000000000000000000000000000000000000009111301
0100000000000000000000080101010000000000000000000000000000000000000000000000000000000000000010121401
0100000000000000000000000101010000000000000000000000000000000000000000000000000000000000000009111301
0100000000000000000000000101010000000000000000000000000000000000000000000000000000000000000010121401
0100000000000000000000000101010000000000000000000000000000000000000000000000000000000000000009111401
0100000000000000000000000101010000000000000000000000000000000000000000000000000000000000000010121401
0100000000000000000000000101010000000000000000000000000000000000000000000000000000000000000009111301
0100000000000000000000000000000000000000000000000000000000000000000000000000000000000000000010111401
0100000000000000000000000000000000000000000000000000000000000000000000000000000000000000000009111301
0100000000000000000000000101010101010101010101010101010101010000000000000000000000000000000010121401
0100000000000000000000000101010101010101010101010101010101010000000000000000000000000000000009111301
0100000000000000000000000101010101010101010101010101010101010000000000000000000000000000000010121401
0100000000000000000000000101010101010101010101010101010101010000000000000000000000000000000009111301
0100000000000000000000000101010101010101010101010101010101010000000000000000000000000000000010121401
0100000000000000000000000101010101010101010101010101010101010000000000000000000000000000000009111301
0100000000000000000000000000000000000000000000091113010101010000000000000000000000000000000010121401
0100000000000000000000000000000000000000000000101214010101010000000000000000000000000000000009111301
0100000000000000000000000000000000000000000000091113010101010000000000000000000000000000000010121401
0100000000000000000000010101010101010101010101010101010101010000000000000000000000000000000009111301
0100000000000000000000010101010101010101010101010101010101010000000000000000000000000000000010121401
0100000000000000000000010101010101010101010101010101010101010000000000000000000000000000000009111301
0100000000000000000000010101010101010101010101010101010101010000000000000000000000000000000010121401
0100000000000000000000010101010101010101010101010101010101010000000000000000000000000000000009111301
0100000000000000000000010101010101010101010101010101010101000000000000000000000000000000000010121401
0100000000000000000000000000000000000000000000000000000000000000000000000000000000000000000009111301
0100000000000000000000000000000000000000000000000000000000000000000000000000000000000000000010121401
0100000000000000001600000000000000000000000000000000000000000000000000000000000000000000000009111301
0100000000000000000017000000000000000000000000000000000000000000000000000000000000000000000010121401
0100000000000000000000170000000000000000000000000000000000000000000000000000000000000000000009111301
0100000000000000000000000000000000000000000000000000000000000000000000000000000000000000000010121401
0100000000000000000000000000010101010101010101000000000000000000000000000000000000000000000009111301
0100000000000000000000010101010101010101010101010101000000000000000000000000000000000000000010121401
0100000000000000000001010101010101010101010101010101010000000000000000000000000000000000000009121301
0100000000000000000001010101010101010101010101010101010100000000000000000000000000000000000010121401
0100000000000000000101010101010101010101010101010101010100000000000000000000000000000000000009111301
0100000000000000000101010101010101010101010101010101010100000000000000000000000000000000000010121401
0100000000000000000101010101000000000000000005010101010100000000000000000000000000000000000009111301
0100000000000000000101010101000000000000000000050101010100000000000000000000000000000000000010121401
0100000000000000000101010101000000000000000000050101010100000000000000000000000000000000000009111301
0100000000000000000101010101010000000000000005010101010104040404040404040404040404040404040410121401
0100000000000000000101010101010000000000000009111301010119191919010101010101010101010101010101010101
0100000000000000000001010101010000000000000010121401010100000006010101010101010101010101010101010101
0100000000000000000000010101010000000000000009111301010000000000010101010101010101010101010101010101
0100000000000000170000000101010000000000000010121401010000000000010101010101010101010101010101010101
0100000000000017000000000000000000000000000501010100000000000000010101000000000001010000000009111301
0100000000000200000000000000000000000000000005000000000000000000010101000000000001010000000010121401
0100000000000000000000000000000000000000000000050000000000000000010101000000000001010000000009111301
0100000000000000000000000000000000000000000000000500000000000000010101000000000000000000000010121401
0100000000000001010101010101010101010101010101010101010101010000010101000000000000000000000009111301
0100000000000001010101010101010101010101010101010101010101010000010101000000000000000000000010121401
0100000000000101010101010101010101010101010101010101010101010000010101000000000000000000000009111301
0100000000000101010101010101010101010101010101010101010101010000010101000000000000000000000010121401
0100000000000001010101010101010101010101010101010101010101010000170000000000000000000000000009111301
0100000000000000000000000000010101010101010101000000000000000001010101010101010101010000000010121401
0100000000000000000000000001010101010101010101010100000000000001010101010101010101010101000009111301
0100000000000000000000010101010101010101010101010101010100000001010101010101010101010101010010121401
0100000000000000000001010101010101010001010101010101010101000001010101010101010101010101010009111301
0100000000000000000101010101010101010005010101010101010101000000000000000000010101010101010010121401
0100000000000000000101010101010101000000050101010101010101000016010000000000000101010101010010111301
0100000000000000000101010101010100000000000501010101010101000005010000000000010101010101010010121401
0100000000000000000001010101010100000000000000050101010101000000000000000001010101010101010009111301
0100000000000003000001010101010000000000000000000500000000000001010101010101010101010101010010121401
0100000000000000000000010101000000000000000000000500000000000001010101010101010101010101000009111301
0100000000001700000000000000000000000000000000000500000000000001010101010101010101010100000010121401
0100000000000000000000000000000000000000000000000500000000000001010101010101010101000000000009111301
0100000000000101010101010101010101010101010101010101000000000000000000000000000000000000000010121401
0100000000000101010101010101010101010101010101010101000000000000000000000000000000000000000009111301
0100000000000101010101010101010101010101010101010101000000000017001700000000000000000000000010121401
0100000000000101010101010101010101010101010101010101000000000000000000000000010101000000000009111301
0100000000000500000000000000000000000000000000000000000000000000160000010101010101010100000010121401
0100000000000500000000000000000000000000000000000000000000000000000001010101010101010100000009111301
0100000000000500000000000000000000000000000000000000000000000000000101010000000000010101000010121401
0100000000000500000000000000000000000000000101010101010000000000010101000000000000010101000009111301
0100000000000101010101010101010101010101010101010101010100000000010101000000000000000101000010121401
0100001600000101010101010101010101010101010101010101010100000000010101000000000000000101000009111301
0100000000000101010101010101010101010101010101010101010100000000010101000000000000010101000010121401
0100000000000101010101010101010101010101010101010101010000000000000101010000000001010101000009111301
0100000000000101010101010101010101010101010101010101010000000000000101010000000101010100000010121401
0100000000000001010101010101010000000000000000000000000000000000000001010000000101010000000009111301
0100000000000000010101010101010101010000000000000000000000000000000000000000000000000000000010121401
0100000000000000000101010101010101010101000000000000000000000000000000000000000000000000000009111301
0100000000000000000000010101010101010101010100000000000000000000000000000000000000000000000010121401
0100000000000000000000000000010101010101010101010000000000000001010101010101010101010100000009111301
0100000000000000000000000000000101010101010101010101010000000001010101010101010101010100000010121401
0100000000000101010101010100000001010101010101010101010000000001010101010101010101010100000009111301
0100000000000101010101010101010101010101010101010101010000000001010101010101010101010100000010121401
0100000000000101010101010101010101010101010101010101010000000003000005000101000000000000000009111301
0100000000000101010101010101010101010101010101010101010000000000000005010101010000000000000010121401
0100000000000001010101010101010101010101010101010101000000000000050101010101010100000000000009111301
0100000000000000000000000000000000000000000000000000000000000000010101010000010101000000000010121401
0100000000000000000000000000000000000000000000000000000000000001010101000000010101010000000009111301
0100000000000000000000000000000000000000000000000000000000000001010100000000000101010000000010121401
0100000000000000000101010101010101010101010101010000000000000001010100000000000001010000000009111301
0100000000000000010101010101010101010101010101010100000000000000000000000000000000000000000010121401
0100000000000001010101010101010101010101010101010101000000000000000000000000000000000000000009111301
0100000000000101010101010101010101010101010101010101000000000000000000000000000000000000000010121401
0100000000010101010101010101010101010101010101010101000000000000000000000000000000000000000009111301
0100000000010101010101010101000000000001010101010101000000000000000000000000000000000000000010121401
0100000000010101010101010300000000000000010101010101000000000000000000000000000000000000000009111301
0100000000010101010101000000000002030000000101010101000000000000000000000000000000000000000010121401
0100000000010101010100000000000001010101000101010101000000000000000000000000000000000000000009111301
0100000000010101010103000000000001010101000101010101000000000000000000000000000000000000000010121401
0100000000010101010101000000000001010101000101010101000000000000000000000000000000000000000009111301
0100000000010101010101000300000001010101010101010101000000000000000000000000000000000000000010121401
0100000000010101010101010101000001010101010101010100000000000000000000000000000000000000000009111301
0100000000010101010101010101000001010101010101010100000000000000000000000000000000000000000010121401
0100000000010101010101010101000001010101010101010000000000000000000000000000000000000000000009111301
0100000000000101010101010101000001010101010101000000000000000000000000000000000000000000000010121401
0100000000000000010101010101000001010101010100000000000000000000000000000000000000000000000009111301
0100000000000000181818181818181818181818180000000000000000000000000000000000000000000000000010121401
0100000000000000000000000000000000000000000000000000000000000000000000000000000000000000000010111301
0100000000000000000000000000000000000000000000000000000000000000000000000000000000000000000010121401
0100000000000000000000000000000000000000000000000000000000000000000000000000000000000000000009111301
0100000000000000000000000000000000000000000000000000000000000000000000000000000000000000000010121401
0100000000000000000000000000000000000000000000000000000000000000000000000000000000000000000010111301
0100000000000000000000000000000000000000000000000000000000000000000000000000000000000000000010121401
0100000000000000000000000000000000000000000000000000000000000000000000000000000000000000050101010101
0101010101010101010101010101010101010101010101010101010101010101010101010101010101010101010101010101
0000000000000000000000000000000000000000000000000000000000000000000000000000000000000000000000000000
0000000000000000000000000000000000000000000000000000000000000000000000000000000000000000000000000000
0000000000000000000000000000000000000000000000000000000000000000000000000000000000000000000000000000
0000000000000000000000000000000000000000000000000000000000000000000000000000000000000000000000000000
0000000000000000000000000000000000000000000000000000000000000000000000000000000000000000000000000000
0000000000000000000000000000000000000000000000000000000000000000000000000000000000000000000000000000
0000000000000000000000000000000000000000000000000000000000000000000000000000000000000000000000000000
0000000000000000000000000000000000000000000000000000000000000000000000000000000000000000000000000000
0000000000000000000000000000000000000000000000000000000000000000000000000000000000000000000000000000
0000000000000000000000000000000000000000000000000000000000000000000000000000000000000000000000000000
0000000000000000000000000000000000000000000000000000000000000000000000000000000000000000000000000000
0000000000000000000000000000000000000000000000000000000000000000000000000000000000000000000000000000
