0000000000000000000000000000000000010101010101010101010101010100000000000000000000000000000000000000
0000000000000000000000000000000000010100000000010101010101010100000000000000000000000000000000000000
0000000000000000000000000000000000010100000015010101010101010100000000000000000000000000000000000000
0000000000000000000000000000000000000000000000010101010101010100000000000000000000000000000000000000
0000000000000000000000000000000005000000000000000000091113010100000000000000000000000000000000000000
0000000000000000000000000000000005000000000000000000101214010100000000000000000000000000000000000000
0000000000000000000000000000000005000000000000000000010101010100000000000000000000000000000000000000
0000000000000000000000000000000005000000000000000000010101010100000000000000000000000000000000000000
0000000000000000000000000000000000000000000000000000010101010100000000000000000000000000000000000000
0000000000000000000000000000000000030000000000000000010101010100000000000000000000000000000000000000
0000000000000000000000000000000000000000000000000000091113010100000000000000000000000000000000000000
0000000000000000000000000000000000001700000000000000101214010100000000000000000000000000000000000000
0000000000000000000000000000000000000000000000000000010101010100000000000000000000000000000000000000
0000000000000000000000000000000000000017000000000000010101010100000000000000000000000000000000000000
0000000000000000000000000000000000000000000000000000010101010100000000000000000000000000000000000000
0000000000000000000000000000000000000000181818181804160101010100000000000000000000000000000000000000
0000000000000000000000000000000000000000010103010101010101010100000000000000000000000000000000000000
0000000000000000000000000000000000000000010101010101010101010100000000000000000000000000000000000000
0000000000000000000000000000000000000008010101010101010101010100000000000000000000000000000000000000
0000000000000000000000000000000000000000010101010101010101010100000000000000000000000000000000000000
0000000000000000000000000000000000000000010101010101010100000000000000000000000000000000000000000000
0000000000000000000000000000000000000007010101010101010100000000000000000000000000000000000000000000
0000000000000000000000000000000000000000010101010101010100000000000000000000000000000000000000000000
0000000000000000000000000000000000000000010101010101010100000000000000000000000000000000000000000000
0000000000000000000000000000000000000000170101010101010100000000000000000000000000000000000000000000
0000000000000000000000000000000000000000010101010101010100000000000000000000000000000000000000000000
0000000000000000000000000000000000000000010101010101010100000000000000000000000000000000000000000000
0000000000000000000000000000000000000007010101010101010100000000000000000000000000000000000000000000
0000000000000000000000000000000000000000010101010101010100000000000000000000000000000000000000000000
0000000000000000000000000000000000000000010101010101010100000000000000000000000000000000000000000000
0000000000000000000000000000000000000000160101010101010100000000000000000000000000000000000000000000
0000000000000000000000000000000000000000010101010101010100000000000000000000000000000000000000000000
0000000000000000000000000000000000000000010101010101010100000000000000000000000000000000000000000000
0000000000000000000000000000000000000000010101010101010100000000000000000000000000000000000000000000
0000000000000000000000000000000000000100091113010101010100000000000000000000000000000000000000000000
0000000000000000000000000000000000070100101214010101010101000000000000000000000000000000000000000000
0000000000000000000000000000000000000100091113010101010101000000000000000000000000000000000000000000
0000000000000000000000000000000000000100101214010101010101000000000000000000000000000000000000000000
0000000000000000000000000000000000000000010101010101010101000000000000000000000000000000000000000000
0000000000000000000000000000000000000000010101010101010101000000000000000000000000000000000000000000
0000000000000000000000000000000000000000010101010101010101000000000000000000000000000000000000000000
0000000000000000000000000000000000000000010101010101010101000000000000000000000000000000000000000000
0000000000000000000000000000000000000000030101010101010101000000000000000000000000000000000000000000
0000000000000000000000000000000000000000171601010101010101000000000000000000000000000000000000000000
0000000000000000000000000000000000000000000101010101010101000000000000000000000000000000000000000000
0000000000000000000000000404040404040400000101010101010101000000000000000000000000000000000000000000
0000000000000000000000000101010101010100000101010101010101000000000000000000000000000000000000000000
0000000000000000000000000101010101010100070101010101010101000000000000000000000000000000000000000000
0000000000000000000000001919191818181800000101010101010101000000000000000000000000000000000000000000
0000000000000000000000000000000000000000000101010101010101000000000000000000000000000000000000000000
0000000000000000000000000000000000000000000101010101010101000000000000000000000000000000000000000000
0000000000000000000000000000000000000000000911130101010101000000000000000000000000000000000000000000
0000000000000000000000000000000000000000001012140101010101000000000000000000000000000000000000000000
0000000000000000000000000000000000000000000101010101010101000000000000000000000000000000000000000000
0000000000000000000000000000000000000000000101010101010101000000000000000000000000000000000000000000
0000000000000000000000000000000000001700000101010101010101000000000000000000000000000000000000000000
0000000000000000000000000000000000000501000101010101010101010101010000000000000000000000000000000000
0000000000000000000000000000000000000501080101010101010101010101010000000000000000000000000000000000
0000000000000000000000000000000000000501000101010101010101010101010000000000000000000000000000000000
0000000000000000010101010101000000000501000101010101010101010101010000000000000000000000000000000000
0000000000000000191919191919010100001600000101010101010101010101010000000000000000000000000000000000
0000000000000000000000000000010100000000000101010101010101010101010000000000000000000000000000000000
0000000000000000000000000000010100000000000101010102191901010101010000000000000000000000000000000000
0000000000000000000000000000010101000000000000050100000001010101010000000000000000000000000000000000
0000000000000000000000000000181818000000000000050100000001010101010000000000000000000000000000000000
0000000000000000000000000000000000000000010000000000000001010101010000000000000000000000000000000000
0000000000000000000000000000000501000000010000000000000801010101010000000000000000000000000000000000
0000000000000000000000000000000101000005010000000000000001010101010000000000000000000000000000000000
0000000000000000000000000000000101000005010000000000000009111301010000000000000000000000000000000000
0000000000000000000000000000000101000000000000000000000010121401010000000000000000000000000000000000
0000000000000000000000000000000501000000000000000000000001010101010000000000000000000000000000000000
0000000000000000000000000000000517000000000000000000000001010101010000000000000000000000000000000000
0000000000000000000101000000000000000000181818181818180401010101010000000000000000000000000000000000
0000000002000000000501000000000000000000010101010101010101010101010000000000000000000000000000000000
0000000000000000000501000000000000000000010101010101010101010101010000000000000000000000000000000000
0000000000000000000101000000000000000000010101010101010101010101010000000000000000000000000000000000
0000000000000000000000000000000000000000010101010101010101010101010000000000000000000000000000000000
0000000000000000000000000000000000000000091113010101010101010101010000000000000000000000000000000000
0000000000000000000003000101000000000000101214010101010101010101010100000000000000000000000000000000
0000000000000000000000001601000000000000030101010101010101010101010000000000000000000000000000000000
0000000000000000000000000501000000000000010101010101010101010101010000000000000000000000000000000000
0000000000000000000000030101000000000000010101010101010101010101010000000000000000000000000000000000
0000000000000000000000000000000000000001010101010101010101000000000000000000000000000000000000000000
0000000000000000000000000000000000000001010101010101010101000000000000000000000000000000000000000000
0000000000000000000000001700000000000001010101010101010101000000000000000000000000000000000000000000
0000000000000000000000000000000001010001010101010101010101000000000000000000000000000000000000000000
0000000000000000000000000000000001010009111301010101010100000000000000000000000000000000000000000000
0000000000000000000000000017000001010010121401010101010100000000000000000000000000000000000000000000
0000000000000000000000000000000001010009111301010101010100000000000000000000000000000000000000000000
0000000000000000000000000000000000000010121401010101010100000000000000000000000000000000000000000000
0000000000000000000000000000010100000501010101010101010100000000000000000000000000000000000000000000
0000000000000000000000000000010100000501010101010101010000000000000000000000000000000000000000000000
0000000000000000000000000000010100000501010101010101010000000000000000000000000000000000000000000000
0000000000000000000000000000010100000501010101010101010000000000000000000000000000000000000000000000
0000000000000000000000000000000000000501010101010101010000000000000000000000000000000000000000000000
0000000000000000000000000000000000000501010101010101010000000000000000000000000000000000000000000000
0000000000000000000000000000050100000501010101010101010000000000000000000000000000000000000000000000
0000000000000000000000000000010101010101010101010101010000000000000000000000000000000000000000000000
0000000000000000000000000000010101010101010101010101010000000000000000000000000000000000000000000000
0000000000000000000017000000011701010101010101010101000000000000000000000000000000000000000000000000
0000000000000000000000000000010101010101010101010101000000000000000000000000000000000000000000000000
0000000000000000000000000000010101010101010101010101000000000000000000000000000000000000000000000000
0000000000000000000000000000010101010101010101010101000000000000000000000000000000000000000000000000
0000000000000000000000000000010101010101010101010100000000000000000000000000000000000000000000000000
0000000000000000000000000000091113010101010101010100000000000000000000000000000000000000000000000000
0000000000000000000000000000101214010101010101010100000000000000000000000000000000000000000000000000
0000000000000000000000000000010101010101010101010100000000000000000000000000000000000000000000000000
0000000000000000000000000000010101010101010101010100000000000000000000000000000000000000000000000000
0000000000000000000000000000010101010101010101010100000000000000000000000000000000000000000000000000
0000000000000000000000000000010101010101010101010100000000000000000000000000000000000000000000000000
0000000000000001010000000000010101010101010101010100000000000000000000000000000000000000000000000000
0000000000000001010000000006010101010101010101010000000000000000000000000000000000000000000000000000
0000000000000001010101010101010101010101010100000000000000000000000000000000000000000000000000000000
0000000000000001010101010101010101010101010000000000000000000000000000000000000000000000000000000000
0000000000000001010101010101010101010100000000000000000000000000000000000000000000000000000000000000
0000000000000000000000000000000000000000000000000000000000000000000000000000000000000000000000000000
0000000000000000000000000000000000000000000000000000000000000000000000000000000000000000000000000000
0000000000000000000000000000000000000000000000000000000000000000000000000000000000000000000000000000
0000000000000000000000000000000000000000000000000000000000000000000000000000000000000000000000000000
0000000000000000000000000000000000000000000000000000000000000000000000000000000000000000000000000000
0000000000000000000000000000000000000000000000000000000000000000000000000000000000000000000000000000
0000000000000000000000000000000000000000000000000000000000000000000000000000000000000000000000000000
0000000000000000000000000000000000000000000000000000000000000000000000000000000000000000000000000000
0000000000000000000000000000000000000000000000000000000000000000000000000000000000000000000000000000
0000000000000000000000000000000000000000000000000000000000000000000000000000000000000000000000000000
0000000000000000000000000000000000000000000000000000000000000000000000000000000000000000000000000000
0000000000000000000000000000000000000000000000000000000000000000000000000000000000000000000000000000
0000000000000000000000000000000000000000000000000000000000000000000000000000000000000000000000000000
0000000000000000000000000000000000000000000000000000000000000000000000000000000000000000000000000000
0000000000000000000000000000000000000000000000000000000000000000000000000000000000000000000000000000
0000000000000000000000000000000000000000000000000000000000000000000000000000000000000000000000000000
0000000000000000000000000000000000000000000000000000000000000000000000000000000000000000000000000000
0000000000000000000000000000000000000000000000000000000000000000000000000000000000000000000000000000
0000000000000000000000000000000000000000000000000000000000000000000000000000000000000000000000000000
0000000000000000000000000000000000000000000000000000000000000000000000000000000000000000000000000000
0000000000000000000000000000000000000000000000000000000000000000000000000000000000000000000000000000
0000000000000000000000000000000000000000000000000000000000000000000000000000000000000000000000000000
0000000000000000000000000000000000000000000000000000000000000000000000000000000000000000000000000000
0000000000000000000000000000000000000000000000000000000000000000000000000000000000000000000000000000
0000000000000000000000000000000000000000000000000000000000000000000000000000000000000000000000000000
0000000000000000000000000000000000000000000000000000000000000000000000000000000000000000000000000000
0000000000000000000000000000000000000000000000000000000000000000000000000000000000000000000000000000
0000000000000000000000000000000000000000000000000000000000000000000000000000000000000000000000000000
0000000000000000000000000000000000000000000000000000000000000000000000000000000000000000000000000000
0000000000000000000000000000000000000000000000000000000000000000000000000000000000000000000000000000
0000000000000000000000000000000000000000000000000000000000000000000000000000000000000000000000000000
0000000000000000000000000000000000000000000000000000000000000000000000000000000000000000000000000000
0000000000000000000000000000000000000000000000000000000000000000000000000000000000000000000000000000
0000000000000000000000000000000000000000000000000000000000000000000000000000000000000000000000000000
0000000000000000000000000000000000000000000000000000000000000000000000000000000000000000000000000000
